#set_communities.py -d data/real_world/
# GMT Fri Sep  6 14:08:20 2024
# 
0,1,4,9,16,23,33,35,41,65,90,93,104
1,25,27,33,37,45,57,89,101,103,105,109
2,3,6,13,14,15,47,60,64,72,74,100,106
3,5,11,26,40,52,58,72,74,81,84,102
4,5,9,16,23,28,41,69,93,104,108
5,90,74,10,11,52,81,84,97,98,107
6,7,32,39,47,55,58,60,64,85,100,106
7,40,108,8,21,22,68,73,77,78,82,111
8,9,41,90,21,22,51,68,77,78,111
9,16,22,23,41,64,93,104,108
10,60,72,74,11,81,84,102,98,107
11,90,104,24,28,50,69,97
12,13,14,26,85,17,18,34,36,38,43
13,45,15,32,39,60,64,100,106,110
14,15,26,38,43,54,71,85,99
15,32,39,47,60,68,92,100,106,114
16,17,23,38,41,67,81,93,104
17,65,27,58,20,62,87,95,96,113
18,19,31,34,36,38,42,54,61,71,99
19,33,35,101,55,36,29,30,44,79,94
20,65,21,36,62,70,75,76,87,96,113
21,108,32,22,46,51,68,77,111
22,23,47,108,51,68,77,78
23,41,78,90,93,104,111
24,90,25,84,28,69,50,66,87,110
25,33,37,45,53,89,103,105,106,109
26,27,34,38,42,43,61,85
27,65,56,62,63,70,76,95,96
28,90,38,50,69,78,113
29,35,101,55,82,42,30,79,80,91,94
30,35,101,109,55,82,50,44,79,94
31,32,55,85,34,43,54,71,99,61,79
32,47,64,100,106,39,49
33,37,45,89,103,105,109
34,35,42,54,61,71,94,99
35,44,55,79,92,94,101
36,37,58,43,59
37,45,80,89,95,103,105,109
38,39,85,43,54,71
39,47,60,100,106,54,82
40,41,72,74,51,52,81,98,102,107
41,67,93,104
42,57,43,63
43,85,61,70,79
44,45,57,48,66,75,86,91,112
45,62,89,103,105,109
46,47,73,111,110,114,67,49,53,83,88
47,60,61,64,100
48,57,98,92,96,75,66,53,91,49,86
49,84,73,110,114,67,53,83,88
50,90,69,68,78,51
51,101,108,68,77,78,111
52,72,74,53,84,98,102,112
53,73,110,114,67,83,86,88
54,55,61,71,99
55,89,101,79,94
56,65,57,106,62,87,95,96,70,76
57,75,86,91,92,112
58,101,59,63,88,97,114
59,60,97,113,76,66,63
60,64,71,106
61,71,99,92,62
62,105,70,76,87,95
63,65,109,64,97,112
64,100,106,111
65,66,70,87,96,113
66,92,75,76,86,91,112
67,104,68,73,110,114,83,88
68,108,78,111
69,90,70,83,88,91,95
70,103,95,113,76
71,72,99
72,104,74,81,102,107
73,74,77,83,88,110,114
74,82,84,102
75,107,92,76,86,112
76,95,96,113
77,108,98,78,82,111
78,108,111
79,101,109,80,94
80,93,105,85,82,110,94,86,91
81,82,83,84,98,107
82,93,100,94
83,84,110,114,88
84,98,107
85,99
86,97,92,87,91
87,104,95,96,113
88,89,107,110,114
89,99,103,105,109
90
91,93,92,112
92,106,112
93,104
94,101
95,113
96,112,113
97,98,112
98,102,107
99,100
100,102
101
102,103,107
103,105,109
104,114
105,109
106
107
108,111
109
110,114
111
112
113
114
