id,ground_truth,CNM,Combo,Leiden,Louvain,Paris,RB-C,RB-ER,Significance,Eigenvector,RSC-K,RSC-SSE,RSC-V,Spectral,Deepwalk,Fairwalk,Node2Vec,Infomap,Spinglass,Walktrap,Fluid,Label Propagation,EM,SBM,SBM - Nested
0,0,2,1,1,1,1,1,1,1,2,1,1,1,1,1,1,1,1,1,0,1,1,0,0,0
1,0,1,1,1,1,1,1,1,1,1,1,1,1,1,1,1,1,1,1,0,0,1,0,0,0
2,0,1,1,1,1,1,1,1,1,1,1,1,0,0,0,1,0,1,1,2,0,0,0,0,0
3,0,1,1,1,1,1,1,1,1,1,1,1,1,1,1,1,1,1,1,0,0,1,0,0,0
4,0,2,3,3,3,1,3,2,5,2,1,1,1,1,1,1,1,2,3,3,1,1,0,0,0
5,0,2,3,3,3,1,3,2,2,2,1,1,1,1,1,1,1,2,3,3,1,2,0,0,0
6,0,2,3,3,3,1,3,2,2,2,1,1,1,1,1,1,1,2,3,3,1,2,0,0,0
7,0,1,1,1,1,1,1,1,1,1,1,1,1,1,1,1,1,1,1,0,0,1,0,0,0
8,0,0,0,0,0,0,0,0,4,0,0,0,0,0,0,0,0,0,0,2,0,0,1,0,0
9,1,1,0,0,0,1,0,4,10,0,0,0,0,0,0,0,0,1,0,2,0,0,1,0,0
10,0,2,3,3,3,1,3,2,5,2,1,1,1,1,1,1,1,2,3,3,1,1,0,0,0
11,0,2,1,1,1,1,1,5,11,2,1,1,1,1,1,1,1,1,1,0,1,1,0,0,0
12,0,1,1,1,1,1,1,1,8,1,1,1,1,1,1,1,1,1,1,0,1,1,0,0,0
13,0,1,1,1,1,1,1,1,1,1,1,1,1,1,1,1,1,1,1,2,0,1,0,0,0
14,1,0,0,0,0,0,0,0,0,0,0,0,0,0,0,0,0,0,0,1,0,0,1,0,0
15,1,0,0,0,0,0,0,0,0,0,0,0,0,0,0,0,0,0,0,1,0,0,1,0,0
16,0,2,3,3,3,1,3,2,2,2,1,1,1,1,1,1,1,2,3,3,1,2,0,0,0
17,0,1,1,1,1,1,1,1,13,1,1,1,1,1,1,1,1,1,1,0,1,1,0,0,0
18,1,0,0,0,0,0,0,0,0,0,0,0,0,0,0,0,0,0,0,1,0,0,1,0,0
19,0,2,1,1,1,1,1,1,12,1,1,1,1,1,1,1,1,1,1,0,0,1,0,0,0
20,1,0,0,0,0,0,0,0,0,0,0,0,0,0,0,0,0,0,0,1,0,0,1,0,0
21,0,1,1,1,1,1,1,1,9,1,1,1,1,1,1,1,1,1,1,0,0,1,0,0,0
22,1,0,0,0,0,0,0,0,0,0,0,0,0,0,0,0,0,0,0,1,0,0,1,0,0
23,1,0,2,2,2,0,2,0,6,3,0,0,0,0,0,0,0,0,2,4,0,0,1,0,0
24,1,0,2,2,2,0,2,3,3,3,0,0,0,0,0,0,0,0,2,4,1,1,1,0,0
25,1,0,2,2,2,0,2,3,3,3,0,0,0,0,0,0,0,0,2,4,1,1,1,0,0
26,1,0,0,0,0,0,0,0,7,0,0,0,0,0,0,0,0,0,0,1,0,0,1,0,0
27,1,0,2,2,2,0,2,3,6,3,0,0,0,0,0,0,0,0,2,4,0,0,1,0,0
28,1,0,2,2,2,0,2,3,14,3,0,0,0,0,0,0,0,0,2,2,0,0,1,0,0
29,1,0,0,0,0,0,0,0,7,0,0,0,0,0,0,0,0,0,0,1,0,0,1,0,0
30,1,0,0,0,0,0,0,0,4,0,0,0,0,0,0,0,0,0,0,2,0,0,1,0,0
31,1,0,2,2,2,0,2,3,3,3,0,0,0,0,0,0,0,0,2,2,1,1,1,0,0
32,1,0,0,0,0,0,0,0,0,0,0,0,0,0,0,0,0,0,0,1,0,0,0,0,0
33,1,0,0,0,0,0,0,0,0,0,0,0,0,0,0,0,0,0,0,1,0,0,0,0,0
